CO_REGSAUD;DS_NOME;Ano;Pop_Total;Pop_Hom;Pop_Mul;p_Pop_Hom;p_Pop_Mul
11001;Vale do Jamari;2010;222668;115206;107462;51,74;48,26
11002;Café;2010;161019;81017;80002;50,32;49,68
11003;Central;2010;343531;173507;170024;50,51;49,49
11004;Madeira-Mamoré;2010;521074;265185;255889;50,89;49,11
11005;Zona da Mata;2010;135241;69265;65976;51,22;48,78
11006;Cone Sul;2010;137534;69273;68261;50,37;49,63
11007;Vale do Guaporé;2010;41342;21704;19638;52,50;47,50
12001;Alto Acre;2010;58661;30071;28590;51,26;48,74
12002;Baixo Acre e Purus;2010;475391;236392;238999;49,73;50,27
12003;Juruá e Tarauacá/Envira;2010;199507;101861;97646;51,06;48,94
13001;Entorno Manaus e Alto Rio Negro;2010;2119745;1045254;1074491;49,31;50,69
13002;Rio Negro e Solimões;2010;252027;130566;121461;51,81;48,19
13003;Rio Madeira;2010;165663;87105;78558;52,58;47,42
13004;Médio Amazonas;2010;149130;77286;71844;51,82;48,18
13005;Baixo Amazonas;2010;214881;111340;103541;51,81;48,19
13006;Regional Purus;2010;118314;62022;56292;52,42;47,58
13007;Regional Juruá;2010;117043;60286;56757;51,51;48,49
13008;Triângulo;2010;123088;64056;59032;52,04;47,96
13009;Alto Solimões;2010;224094;115264;108830;51,44;48,56
14001;Centro Norte;2010;377473;190176;187297;50,38;49,62
14002;Sul;2010;73006;38683;34323;52,99;47,01
15001;Araguaia;2010;472933;247778;225155;52,39;47,61
15002;Baixo Amazonas;2010;702476;356473;346003;50,75;49,25
15003;Carajás;2010;739954;380023;359931;51,36;48,64
15004;Lago de Tucuruí;2010;372764;190745;182019;51,17;48,83
15006;Metropolitana I;2010;2042417;974097;1068320;47,69;52,31
15007;Metropolitana II;2010;326299;169185;157114;51,85;48,15
15008;Metropolitana III;2010;826857;419590;407267;50,75;49,25
15009;Rio Caetés;2010;485795;249029;236766;51,26;48,74
15010;Tapajós;2010;209531;109541;99990;52,28;47,72
15011;Tocantins;2010;607179;311657;295522;51,33;48,67
15012;Xingu;2010;307836;161133;146703;52,34;47,66
15013;Marajó I;2010;210936;109202;101734;51,77;48,23
15014;Marajó II;2010;276074;143384;132690;51,94;48,06
16001;Área Central;2010;444928;220474;224454;49,55;50,45
16002;Área Norte;2010;53934;28412;25522;52,68;47,32
16003;Área Sudoeste;2010;170664;86249;84415;50,54;49,46
17001;Médio Norte Araguaia;2010;262650;132335;130315;50,38;49,62
17002;Bico do Papagaio;2010;191094;97180;93914;50,85;49,15
17003;Sudeste;2010;92376;47679;44697;51,61;48,39
17004;Cerrado Tocantins Araguaia;2010;146205;75253;70952;51,47;48,53
17005;Ilha do Bananal;2010;171546;87250;84296;50,86;49,14
17006;Capim Dourado;2010;301576;150569;151007;49,93;50,07
17007;Cantão;2010;114648;59211;55437;51,65;48,35
17008;Amor Perfeito;2010;103350;52947;50403;51,23;48,77
21001;Açailândia;2010;269834;137223;132611;50,85;49,15
21002;Bacabal;2010;259862;128539;131323;49,46;50,54
21003;Balsas;2010;232150;118309;113841;50,96;49,04
21004;Barra do Corda;2010;215603;110038;105565;51,04;48,96
21005;Caxias;2010;286636;141328;145308;49,31;50,69
21006;Chapadinha;2010;350224;177239;172985;50,61;49,39
21007;Codó;2010;292653;144231;148422;49,28;50,72
21008;Imperatriz;2010;489278;243707;245571;49,81;50,19
21009;Itapecuru Mirim;2010;344645;173083;171562;50,22;49,78
21010;Pedreiras;2010;212191;105076;107115;49,52;50,48
21011;Pinheiro;2010;373763;189534;184229;50,71;49,29
21012;Presidente Dutra;2010;277687;138907;138780;50,02;49,98
21013;Rosário;2010;270082;138507;131575;51,28;48,72
21014;Santa Inês;2010;372752;186734;186018;50,10;49,90
21015;São João dos Patos;2010;232543;116446;116097;50,08;49,92
21016;São Luís;2010;1331181;628967;702214;47,25;52,75
21017;Timon;2010;233207;114820;118387;49,24;50,76
21018;Viana;2010;253336;127609;125727;50,37;49,63
21019;Zé Doca;2010;277162;141218;135944;50,95;49,05
22001;Carnaubais;2010;157071;78365;78706;49,89;50,11
22002;Chapada das Mangabeiras;2010;187457;95752;91705;51,08;48,92
22003;Cocais;2010;385072;192479;192593;49,99;50,01
22004;Entre Rios;2010;1166815;556066;610749;47,66;52,34
22005;Planície Litorânea;2010;265202;130865;134337;49,35;50,65
22006;Serra da Capivara;2010;140738;70975;69763;50,43;49,57
22007;Tabuleiros do Alto Parnaíba;2010;44665;22597;22068;50,59;49,41
22008;Vale do Canindé;2010;104492;51640;52852;49,42;50,58
22009;Vale do Rio Guaribas;2010;359863;178013;181850;49,47;50,53
22010;Vale do Sambito;2010;104024;51014;53010;49,04;50,96
22011;Vale dos Rios Piauí e Itaueiras;2010;202961;100656;102305;49,59;50,41
23001;1ª Região Fortaleza;2010;2606663;1226287;1380376;47,04;52,96
23002;2ª Região Caucaia;2010;564060;279964;284096;49,63;50,37
23003;3ª Região Maracanaú;2010;492339;242866;249473;49,33;50,67
23004;4ª Região Baturité;2010;133185;66897;66288;50,23;49,77
23005;5ª Região Canindé;2010;195281;97862;97419;50,11;49,89
23006;6ª Região Itapipoca;2010;272494;138682;133812;50,89;49,11
23007;7ª Região Aracati;2010;109684;54659;55025;49,83;50,17
23008;8ª Região Quixadá;2010;306026;152435;153591;49,81;50,19
23009;9ª Região Russas;2010;190863;95165;95698;49,86;50,14
23010;10ª Região Limoeiro do Norte;2010;216392;106784;109608;49,35;50,65
23011;11ª Região Sobral;2010;608006;300527;307479;49,43;50,57
23012;12ª Região Acaraú;2010;210784;106804;103980;50,67;49,33
23013;13ª Região Tianguá;2010;295210;146695;148515;49,69;50,31
23014;14ª Região Tauá;2010;110878;54586;56292;49,23;50,77
23015;15ª Região Crateús;2010;290577;142946;147631;49,19;50,81
23016;16ª Região Camocim;2010;150108;75099;75009;50,03;49,97
23017;17ª Região Icó;2010;168042;82801;85241;49,27;50,73
23018;18ª Região Iguatú;2010;306778;151363;155415;49,34;50,66
23019;19ª Região Brejo Santo;2010;205272;101236;104036;49,32;50,68
23020;20ª Região Crato;2010;328410;159213;169197;48,48;51,52
23021;21ª Região Juazeiro do Norte;2010;397246;190314;206932;47,91;52,09
23022;22ª Região Cascavel;2010;294083;146903;147180;49,95;50,05
24001;1ª Região de Saúde - São José de Mipibu;2010;351502;176313;175189;50,16;49,84
24002;2ª Região de Saúde - Mossoró;2010;436940;214691;222249;49,14;50,86
24003;3ª Região de Saúde - João Câmara;2010;323763;163253;160510;50,42;49,58
24004;4ª Região de Saúde - Caicó;2010;295726;145313;150413;49,14;50,86
24005;5ª Região de Saúde - Santa Cruz;2010;185719;92952;92767;50,05;49,95
24006;6ª Região de Saúde - Pau dos Ferros;2010;242006;119508;122498;49,38;50,62
24007;7ª Região de Saúde - Metropolitana;2010;1187899;564750;623149;47,54;52,46
24008;8ª Região de Saúde - Açu;2010;144472;72107;72365;49,91;50,09
25001;1ª Região Mata Atlântica;2010;1189121;564304;624817;47,46;52,54
25002;2ª Região;2010;298428;146549;151879;49,11;50,89
25003;3ª Região;2010;188406;91973;96433;48,82;51,18
25004;4ª Região;2010;107044;53162;53882;49,66;50,34
25005;5ª Região;2010;114475;56506;57969;49,36;50,64
25006;6ª Região;2010;224550;109125;115425;48,60;51,40
25007;7ª Região;2010;146601;72414;74187;49,40;50,60
25008;8ª Região;2010;111375;55070;56305;49,45;50,55
25009;9ª Região;2010;167971;82094;85877;48,87;51,13
25010;10ª Região;2010;112217;54840;57377;48,87;51,13
25011;11ª Região;2010;80991;40344;40647;49,81;50,19
25012;12ª Região;2010;169225;83292;85933;49,22;50,78
25013;13ª Região;2010;58605;28489;30116;48,61;51,39
25014;14ª Região;2010;142023;70639;71384;49,74;50,26
25015;15ª Região;2010;144693;71314;73379;49,29;50,71
25016;16ª Região;2010;510803;244264;266539;47,82;52,18
26001;Afogados da Ingazeira;2010;180780;88568;92212;48,99;51,01
26002;Arcoverde;2010;382602;187586;195016;49,03;50,97
26003;Caruaru;2010;1241469;601414;640055;48,44;51,56
26004;Garanhuns;2010;513660;249647;264013;48,60;51,40
26005;Goiana;2010;302767;148100;154667;48,92;51,08
26006;Limoeiro;2010;566331;274772;291559;48,52;51,48
26007;Ouricuri;2010;327866;162283;165583;49,50;50,50
26008;Palmares;2010;574905;284554;290351;49,50;50,50
26009;Petrolina;2010;434713;213467;221246;49,11;50,89
26010;Recife;2010;3908757;1842530;2066227;47,14;52,86
26011;Salgueiro;2010;138719;68477;70242;49,36;50,64
26012;Serra Talhada;2010;223879;109283;114596;48,81;51,19
27001;1ª Região de Saúde;2010;1168689;552266;616423;47,26;52,74
27002;2ª Região de Saúde;2010;155760;78001;77759;50,08;49,92
27003;3ª Região de Saúde;2010;213901;106190;107711;49,64;50,36
27004;4ª Região de Saúde;2010;139785;69314;70471;49,59;50,41
27005;5ª Região de Saúde;2010;220237;108204;112033;49,13;50,87
27006;6ª Região de Saúde;2010;195429;96605;98824;49,43;50,57
27007;7ª Região de Saúde;2010;495431;241203;254228;48,69;51,31
27008;8ª Região de Saúde;2010;152569;73699;78870;48,31;51,69
27009;9ª Região de Saúde;2010;226824;111749;115075;49,27;50,73
27010;10ª Região de Saúde;2010;151869;74536;77333;49,08;50,92
28001;Aracaju;2010;749740;353021;396719;47,09;52,91
28002;Estância;2010;229171;113637;115534;49,59;50,41
28003;Itabaiana;2010;232495;114784;117711;49,37;50,63
28004;Lagarto;2010;242337;119096;123241;49,14;50,86
28005;Nossa Senhora da Glória;2010;156182;78727;77455;50,41;49,59
28006;Nossa Senhora do Socorro;2010;306624;150333;156291;49,03;50,97
28007;Propriá;2010;151468;75443;76025;49,81;50,19
29001;Alagoinhas;2010;506424;249248;257176;49,22;50,78
29002;Barreiras;2010;400942;204949;195993;51,12;48,88
29003;Brumado;2010;400617;200260;200357;49,99;50,01
29004;Camaçari;2010;524326;259326;265000;49,46;50,54
29005;Cruz das Almas;2010;250565;121205;129360;48,37;51,63
29006;Feira de Santana;2010;1073837;517265;556572;48,17;51,83
29007;Guanambi;2010;430702;216711;213991;50,32;49,68
29008;Ibotirama;2010;184238;94128;90110;51,09;48,91
29009;Ilhéus;2010;323213;160744;162469;49,73;50,27
29010;Irecê;2010;393543;198185;195358;50,36;49,64
29011;Itaberaba;2010;244684;121359;123325;49,60;50,40
29012;Itabuna;2010;512102;251385;260717;49,09;50,91
29013;Itapetinga;2010;240507;121219;119288;50,40;49,60
29014;Jacobina;2010;377710;187904;189806;49,75;50,25
29015;Jequié;2010;492199;244404;247795;49,66;50,34
29016;Juazeiro;2010;494431;247210;247221;50,00;50,00
29017;Paulo Afonso;2010;236853;116767;120086;49,30;50,70
29018;Porto Seguro;2010;343347;172290;171057;50,18;49,82
29019;Ribeira do Pombal;2010;306847;152945;153902;49,84;50,16
29020;Salvador;2010;3142268;1475900;1666368;46,97;53,03
29021;Santa Maria da Vitória;2010;291663;147915;143748;50,71;49,29
29022;Santo Antônio de Jesus;2010;436670;214751;221919;49,18;50,82
29023;Seabra;2010;175795;87309;88486;49,67;50,33
29024;Senhor do Bonfim;2010;285523;142830;142693;50,02;49,98
29025;Serrinha;2010;604086;302373;301713;50,05;49,95
29026;Teixeira de Freitas;2010;416859;209061;207798;50,15;49,85
29027;Valença;2010;294247;148740;145507;50,55;49,45
29028;Vitória da Conquista;2010;632708;311883;320825;49,29;50,71
31001;Águas Formosas;2010;58036;29581;28455;50,97;49,03
31002;Além Paraíba;2010;55791;27161;28630;48,68;51,32
31003;Alfenas Machado;2010;305376;153751;151625;50,35;49,65
31004;Almenara;2010;175002;89336;85666;51,05;48,95
31005;Araçuaí;2010;88413;44493;43920;50,32;49,68
31006;Araxá;2010;167704;84461;83243;50,36;49,64
31007;Barbacena;2010;225183;109857;115326;48,79;51,21
31008;Belo Horizonte Nova Lima Caeté;2010;3185567;1510288;1675279;47,41;52,59
31009;Betim;2010;624062;310865;313197;49,81;50,19
31010;Bom Despacho;2010;100858;50181;50677;49,75;50,25
31011;Brasília de Minas São Francisco;2010;234588;119935;114653;51,13;48,87
31012;Carangola;2010;123872;62321;61551;50,31;49,69
31013;Caratinga;2010;192172;95833;96339;49,87;50,13
31014;Conselheiro Lafaiete Congonhas;2010;288371;142198;146173;49,31;50,69
31015;Contagem;2010;788210;383508;404702;48,66;51,34
31016;Coração de Jesus;2010;46979;23946;23033;50,97;49,03
31017;Coronel Fabriciano Timóteo;2010;217790;105617;112173;48,49;51,51
31018;Curvelo;2010;174714;86241;88473;49,36;50,64
31019;Diamantina;2010;166513;82423;84090;49,50;50,50
31020;Divinópolis Santo Antônio do Monte;2010;429544;212627;216917;49,50;50,50
31021;Formiga;2010;126639;63277;63362;49,97;50,03
31022;Francisco Sá;2010;70965;36524;34441;51,47;48,53
31023;Frutal Iturama;2010;160188;82094;78094;51,25;48,75
31024;Governador Valadares;2010;410066;197806;212260;48,24;51,76
31025;Guanhães;2010;113607;56140;57467;49,42;50,58
31026;Guaxupé;2010;154619;79015;75604;51,10;48,90
31027;Ipatinga;2010;374405;183574;190831;49,03;50,97
31028;Itabira;2010;218442;106488;111954;48,75;51,25
31029;Itajubá;2010;196039;98230;97809;50,11;49,89
31030;Itaobim;2010;80733;40773;39960;50,50;49,50
31031;Itaúna;2010;114169;56642;57527;49,61;50,39
31032;Ituiutaba;2010;184303;92720;91583;50,31;49,69
31033;Janaúba Monte Azul;2010;265812;132959;132853;50,02;49,98
31034;Januária;2010;110272;55078;55194;49,95;50,05
31035;João Monlevade;2010;132648;63573;69075;47,93;52,07
31036;João Pinheiro;2010;68117;34981;33136;51,35;48,65
31037;Juiz de Fora Lima Duarte Bom Jardim Min;2010;637712;305414;332298;47,89;52,11
31038;Lavras;2010;169756;83501;86255;49,19;50,81
31039;Leopoldina Cataguases;2010;173848;85327;88521;49,08;50,92
31040;Manga;2010;57647;29044;28603;50,38;49,62
31041;Manhuaçu;2010;323342;162041;161301;50,11;49,89
31042;Mantena;2010;68145;33509;34636;49,17;50,83
31043;Minas Novas Turmalina Capelinha;2010;118517;59182;59335;49,94;50,06
31044;Montes Claros Bocaiúva;2010;454682;221330;233352;48,68;51,32
31045;Muriaé;2010;163996;80808;83188;49,27;50,73
31046;Nanuque;2010;69315;34173;35142;49,30;50,70
31047;Ouro Preto;2010;169949;83197;86752;48,95;51,05
31048;Padre Paraíso;2010;59698;30011;29687;50,27;49,73
31049;Pará de Minas;2010;208105;105011;103094;50,46;49,54
31050;Passos Piumhi;2010;273649;138153;135496;50,49;49,51
31051;Patos de Minas;2010;332507;166661;165846;50,12;49,88
31052;Patrocínio Monte Carmelo;2010;183217;93193;90024;50,86;49,14
31053;Pedra Azul;2010;51404;25685;25719;49,97;50,03
31054;Pirapora;2010;138356;69293;69063;50,08;49,92
31055;Poços de Caldas;2010;215747;105677;110070;48,98;51,02
31056;Ponte Nova;2010;212256;104072;108184;49,03;50,97
31057;Pouso Alegre;2010;495945;250772;245173;50,56;49,44
31058;Resplendor;2010;87994;43155;44839;49,04;50,96
31059;Salinas Taiobeiras;2010;197999;99352;98647;50,18;49,82
31060;Santa Maria do Suaçuí São João Evangeli;2010;101991;50821;51170;49,83;50,17
31061;Santo Antônio do Amparo Campo Belo;2010;194295;96790;97505;49,82;50,18
31062;Santos Dumont;2010;50465;24629;25836;48,80;51,20
31063;São João del Rei;2010;227178;111745;115433;49,19;50,81
31064;São João Nepomuceno Bicas;2010;69213;33832;35381;48,88;51,12
31065;São Lourenço;2010;250451;124148;126303;49,57;50,43
31066;São Sebastião do Paraíso;2010;119965;60061;59904;50,07;49,93
31067;Sete Lagoas;2010;410587;202566;208021;49,34;50,66
31068;Teófilo Otoni Malacacheta Itambacuri;2010;316409;154459;161950;48,82;51,18
31069;Três Corações;2010;123868;61985;61883;50,04;49,96
31070;Três Pontas;2010;120384;60096;60288;49,92;50,08
31071;Ubá;2010;291775;145560;146215;49,89;50,11
31072;Uberaba;2010;369920;183023;186897;49,48;50,52
31073;Uberlândia Araguari;2010;811426;399077;412349;49,18;50,82
31074;Unaí;2010;252330;128356;123974;50,87;49,13
31075;Varginha;2010;183803;90317;93486;49,14;50,86
31076;Vespasiano;2010;279500;137012;142488;49,02;50,98
31077;Viçosa;2010;130215;64342;65873;49,41;50,59
32001;Central;2010;571302;284870;286432;49,86;50,14
32002;Metropolitana;2010;1935393;943503;991890;48,75;51,25
32003;Norte;2010;384861;192520;192341;50,02;49,98
32004;Sul;2010;623396;310325;313071;49,78;50,22
33001;Baia da Ilha Grande;2010;243500;121592;121908;49,94;50,06
33002;Baixada Litorânea;2010;679493;333445;346048;49,07;50,93
33003;Centro-Sul;2010;319351;155088;164263;48,56;51,44
33004;Médio Paraíba;2010;855193;412207;442986;48,20;51,80
33005;Metropolitana I;2010;9873610;4669049;5204561;47,29;52,71
33006;Metropolitana II;2010;1940391;923356;1017035;47,59;52,41
33007;Noroeste;2010;330093;161805;168288;49,02;50,98
33008;Norte;2010;836915;408502;428413;48,81;51,19
33009;Serrana;2010;911383;440635;470748;48,35;51,65
35011;Alto do Tietê;2010;2663739;1302075;1361664;48,88;51,12
35012;Franco da Rocha;2010;517675;259368;258307;50,10;49,90
35013;Mananciais;2010;986998;482506;504492;48,89;51,11
35014;Rota dos Bandeirantes;2010;1710732;830069;880663;48,52;51,48
35015;Grande ABC;2010;2551328;1230955;1320373;48,25;51,75
35016;São Paulo;2010;11253503;5328632;5924871;47,35;52,65
35021;Central do DRS II;2010;278351;136873;141478;49,17;50,83
35022;Lagos do DRS II;2010;190489;97436;93053;51,15;48,85
35023;Consórcios do DRS II;2010;250483;124418;126065;49,67;50,33
35031;Central do DRS III;2010;285700;139453;146247;48,81;51,19
35032;Centro Oeste do DRS III;2010;131724;65643;66081;49,83;50,17
35033;Norte do DRS III;2010;146949;72978;73971;49,66;50,34
35034;Coração do DRS III;2010;355884;176027;179857;49,46;50,54
35041;Baixada Santista;2010;1664136;796701;867435;47,87;52,13
35051;Norte - Barretos;2010;268546;132609;135937;49,38;50,62
35052;Sul - Barretos;2010;140721;69625;71096;49,48;50,52
35061;Vale do Jurumirim;2010;277385;139665;137720;50,35;49,65
35062;Bauru;2010;593319;294550;298769;49,64;50,36
35063;Polo Cuesta;2010;279326;138154;141172;49,46;50,54
35064;Jaú;2010;319496;158204;161292;49,52;50,48
35065;Lins;2010;155097;76896;78201;49,58;50,42
35071;Bragança;2010;416655;206478;210177;49,56;50,44
35072;Região Metropolitana de Campinas;2010;2793185;1371658;1421527;49,11;50,89
35073;Jundiaí;2010;698724;344535;354189;49,31;50,69
35074;Circuito das Águas;2010;123346;60672;62674;49,19;50,81
35081;Três Colinas;2010;386704;190104;196600;49,16;50,84
35082;Alta Anhanguera;2010;146942;73027;73915;49,70;50,30
35083;Alta Mogiana;2010;116161;57466;58695;49,47;50,53
35091;Adamantina;2010;128287;66876;61411;52,13;47,87
35092;Assis;2010;236188;116620;119568;49,38;50,62
35093;Marília;2010;361514;176789;184725;48,90;51,10
35094;Ourinhos;2010;217871;106987;110884;49,11;50,89
35095;Tupã;2010;124548;61347;63201;49,26;50,74
35101;Araras;2010;309911;153752;156159;49,61;50,39
35102;Limeira;2010;332852;164507;168345;49,42;50,58
35103;Piracicaba;2010;532227;262336;269891;49,29;50,71
35104;Rio Claro;2010;237594;118082;119512;49,70;50,30
35111;Alta Paulista;2010;125690;64379;61311;51,22;48,78
35112;Alta Sorocabana;2010;380077;186016;194061;48,94;51,06
35113;Alto Capivari;2010;56088;27780;28308;49,53;50,47
35114;Extremo Oeste Paulista;2010;92616;46581;46035;50,29;49,71
35115;Pontal do Paranapanema;2010;67721;33940;33781;50,12;49,88
35121;Vale do Ribeira;2010;273566;137452;136114;50,24;49,76
35131;Horizonte Verde;2010;393431;196868;196563;50,04;49,96
35132;Aquífero Guarani;2010;807106;392434;414672;48,62;51,38
35133;Vale das Cachoeiras;2010;127452;63289;64163;49,66;50,34
35141;Baixa Mogiana;2010;302331;149715;152616;49,52;50,48
35142;Mantiqueira;2010;262825;129945;132880;49,44;50,56
35143;Rio Pardo;2010;208625;104880;103745;50,27;49,73
35151;Catanduva;2010;291575;145637;145938;49,95;50,05
35152;Santa Fé do Sul;2010;44269;21630;22639;48,86;51,14
35153;Jales;2010;100705;50146;50559;49,79;50,21
35154;Fernandópolis;2010;110626;54477;56149;49,24;50,76
35155;São José do Rio Preto;2010;649787;316671;333116;48,73;51,27
35156;José Bonifácio;2010;91718;46164;45554;50,33;49,67
35157;Votuporanga;2010;184091;92112;91979;50,04;49,96
35161;Itapetininga;2010;451399;227492;223907;50,40;49,60
35162;Itapeva;2010;272676;136397;136279;50,02;49,98
35163;Sorocaba;2010;1518941;753471;765470;49,61;50,39
35171;Alto Vale do Paraíba;2010;975338;478865;496473;49,10;50,90
35172;Circuito da Fé e Vale Histórico;2010;450280;221173;229107;49,12;50,88
35173;Litoral Norte;2010;281779;140350;141429;49,81;50,19
35174;Vale do Paraíba/Região Serrana;2010;557197;275936;281261;49,52;50,48
41001;1ª RS Paranaguá;2010;265392;131448;133944;49,53;50,47
41002;2ª RS Metropolitana;2010;3223836;1569212;1654624;48,68;51,32
41003;3ª RS Ponta Grossa;2010;575463;284100;291363;49,37;50,63
41004;4ª RS Irati;2010;160962;81321;79641;50,52;49,48
41005;5ª RS Guarapuava;2010;441070;220067;221003;49,89;50,11
41006;6ª RS União da Vitória;2010;165299;83322;81977;50,41;49,59
41007;7ª RS Pato Branco;2010;249793;123060;126733;49,26;50,74
41008;8ª RS Francisco Beltrão;2010;337703;168441;169262;49,88;50,12
41009;9ª RS Foz do Iguaçu;2010;388795;189978;198817;48,86;51,14
41010;10ª RS Cascavel;2010;507385;250574;256811;49,39;50,61
41011;11ª RS Campo Mourão;2010;334125;164906;169219;49,35;50,65
41012;12ª RS Umuarama;2010;265092;130698;134394;49,30;50,70
41013;13ª RS Cianorte;2010;142433;70538;71895;49,52;50,48
41014;14ª RS Paranavaí;2010;260544;128889;131655;49,47;50,53
41015;15ª RS Maringá;2010;733404;357944;375460;48,81;51,19
41016;16ª RS Apucarana;2010;346972;170731;176241;49,21;50,79
41017;17ª RS Londrina;2010;871267;422795;448472;48,53;51,47
41018;18ª RS Cornélio Procópio;2010;225961;111536;114425;49,36;50,64
41019;19ª RS Jacarezinho;2010;278111;138289;139822;49,72;50,28
41020;20ª RS Toledo;2010;358660;176116;182544;49,10;50,90
41021;21ª RS Telêmaco Borba;2010;172922;87193;85729;50,42;49,58
41022;22ª RS Ivaiporã;2010;139337;69836;69501;50,12;49,88
42001;Extremo Oeste;2010;223547;112701;110846;50,41;49,59
42002;Oeste;2010;319662;159662;160000;49,95;50,05
42003;Xanxerê;2010;189054;94453;94601;49,96;50,04
42004;Alto Vale do Itajaí;2010;269424;135504;133920;50,29;49,71
42005;Foz do Rio Itajaí;2010;555564;273073;282491;49,15;50,85
42006;Médio Vale do Itajaí;2010;666938;330203;336735;49,51;50,49
42007;Grande Florianópolis;2010;1012233;496184;516049;49,02;50,98
42008;Meio Oeste;2010;179824;89285;90539;49,65;50,35
42009;Alto Vale do Rio do Peixe;2010;274305;137046;137259;49,96;50,04
42010;Alto Uruguai Catarinense;2010;141990;70992;70998;50,00;50,00
42011;Nordeste;2010;868530;433531;434999;49,92;50,08
42012;Planalto Norte;2010;354200;177099;177101;50,00;50,00
42013;Serra Catarinense;2010;286238;141607;144631;49,47;50,53
42014;Extremo Sul Catarinense;2010;180808;89725;91083;49,62;50,38
42015;Carbonífera;2010;390791;193562;197229;49,53;50,47
42016;Laguna;2010;335328;165733;169595;49,42;50,58
43001;Região 01 - Verdes Campos;2010;416981;201473;215508;48,32;51,68
43002;Região 02 - Entre Rios;2010;124266;61260;63006;49,30;50,70
43003;Região 03 - Fronteira Oeste;2010;465038;226812;238226;48,77;51,23
43004;Região 04 - Belas Praias;2010;138103;68482;69621;49,59;50,41
43005;Região 05 - Bons Ventos;2010;203016;100419;102597;49,46;50,54
43006;Região 06 - Vale do Paranhana e Costa S;2010;212547;105335;107212;49,56;50,44
43007;Região 07 - Vale dos Sinos;2010;755770;370027;385743;48,96;51,04
43008;Região 08 - Vale do Caí e Metropolitana;2010;717914;349695;368219;48,71;51,29
43009;Região 09 - Carbonífera/Costa Doce;2010;384175;192230;191945;50,04;49,96
43010;Região 10 - Capital e Vale do Gravataí;2010;2225237;1050939;1174298;47,23;52,77
43011;Região 11 - Sete Povos das Missões;2010;286248;141048;145200;49,27;50,73
43012;Região 12 - Portal das Missões;2010;152070;73641;78429;48,43;51,57
43013;Região 13 - Diversidade;2010;222771;109548;113223;49,18;50,82
43014;Região 14 - Fronteira Noroeste;2010;226933;111684;115249;49,21;50,79
43015;Região 15 - Caminho das Águas;2010;187063;93315;93748;49,88;50,12
43016;Região 16 - Alto Uruguai Gaúcho;2010;230814;113581;117233;49,21;50,79
43017;Região 17 - Planalto;2010;382429;185362;197067;48,47;51,53
43018;Região 18 - Araucárias;2010;128088;63640;64448;49,68;50,32
43019;Região 19 - Botucaraí;2010;115609;57913;57696;50,09;49,91
43020;Região 20 - Rota da Produção;2010;161508;79662;81846;49,32;50,68
43021;Região 21 - Sul;2010;845135;409412;435723;48,44;51,56
43022;Região 22 - Pampa;2010;182579;88594;93985;48,52;51,48
43023;Região 23 - Caxias e Hortênsias;2010;532917;261177;271740;49,01;50,99
43024;Região 24 - Campos de Cima da Serra;2010;94963;47173;47790;49,68;50,32
43025;Região 25 - Vinhedos e Basalto;2010;279288;138372;140916;49,54;50,46
43026;Região 26 - Uva Vale;2010;169633;84422;85211;49,77;50,23
43027;Região 27 - Jacuí Centro;2010;200264;98431;101833;49,15;50,85
43028;Região 28 - Vinte e Oito;2010;327158;160300;166858;49,00;51,00
43029;Região 29 - Vales e Montanhas;2010;207963;103086;104877;49,57;50,43
43030;Região 30 - Vale da Luz;2010;117449;58024;59425;49,40;50,60
50001;Campo Grande;2010;1331184;661008;670176;49,66;50,34
50002;Corumbá;2010;123320;62114;61206;50,37;49,63
50003;Dourados;2010;741947;370046;371901;49,87;50,13
50004;Três Lagoas;2010;252573;126760;125813;50,19;49,81
51001;Alto Tapajós;2010;99141;51976;47165;52,43;47,57
51002;Baixada Cuiabana;2010;911482;451213;460269;49,50;50,50
51003;Araguaia Xingu;2010;76577;40629;35948;53,06;46,94
51004;Centro Norte;2010;93238;49264;43974;52,84;47,16
51005;Garças Araguaia;2010;118207;59975;58232;50,74;49,26
51006;Médio Araguaia;2010;81650;42875;38775;52,51;47,49
51007;Médio Norte Matogrossense;2010;206840;106581;100259;51,53;48,47
51008;Noroeste Matogrossense;2010;134064;70712;63352;52,74;47,26
51009;Norte Araguaia Karajá;2010;21466;11288;10178;52,59;47,41
51010;Norte Matogrossense;2010;67874;35164;32710;51,81;48,19
51011;Oeste Matogrossense;2010;185991;93872;92119;50,47;49,53
51012;Sudoeste Matogrossense;2010;108961;55972;52989;51,37;48,63
51013;Sul Matogrossense;2010;452519;231638;220881;51,19;48,81
51014;Teles Pires;2010;329366;171679;157687;52,12;47,88
51015;Vale do Peixoto;2010;95825;49638;46187;51,80;48,20
51016;Vale dos Arinos;2010;51921;27060;24861;52,12;47,88
52001;Central;2010;1643132;790971;852161;48,14;51,86
52002;Centro Sul;2010;765526;382293;383233;49,94;50,06
52003;Entorno Norte;2010;228121;114969;113152;50,40;49,60
52004;Entorno Sul;2010;727652;360887;366765;49,60;50,40
52005;Estrada de Ferro;2010;260446;130668;129778;50,17;49,83
52006;Nordeste I;2010;43510;22171;21339;50,96;49,04
52007;Nordeste II;2010;93754;48188;45566;51,40;48,60
52008;Norte;2010;136966;69869;67097;51,01;48,99
52009;Oeste I;2010;113859;57542;56317;50,54;49,46
52010;Oeste II;2010;106186;53170;53016;50,07;49,93
52011;Pirineus;2010;451730;223227;228503;49,42;50,58
52012;Rio Vermelho;2010;191678;96967;94711;50,59;49,41
52013;São Patrício I;2010;161286;81634;79652;50,61;49,39
52014;Serra da Mesa;2010;119367;60773;58594;50,91;49,09
52015;Sudoeste I;2010;379359;194535;184824;51,28;48,72
52016;Sudoeste II;2010;197588;100548;97040;50,89;49,11
52017;Sul;2010;229382;114813;114569;50,05;49,95
52018;São Patrício II;2010;154246;78402;75844;50,83;49,17
53001;Distrito Federal;2010;2570160;1228880;1341280;47,81;52,19
55;Brasil;2010;190755799;93406990;97348809;48,97;51,03
